Humans: 2
###############
#.............#
#.............#
#.............#
#.............#
#.......@.....#
#.............#
#.............#
#.............#
#.............#
#.............#
#.............#
###...........#
#Z#...........#
###############